11111111111111111111111111111
100000010000C0000001000000001
1001000000000000000000C010001
100100000001000C0000000010001
100000010000C000000E000000001
10010000P0000000000000C000001
100100000001000C0000000010001
11111111111111111111111111111