111111111111111111111111111111111111111111111111111111111111
100001000000000100000000010000000001000000000100000000010011
10P100C001100100C001100100C001100100C001100100C001100100C001
100100000000010000000001000000000100000000010000000001000001
100100100000010010000001001000000100100000010010000001001001
100001000010000100001000010000100001000010000100001000010001
100100C000000100C000000100C000000100C000000100C000000100C001
100100000000010000000001000000000100000000010000000001000001
100100100000010010000001001000000100100000010010000001001001
100001001110000100111000010011100001001110000100111000010011
100100C001100100C001100100C001100100C001100100C001100100C001
100100000000010000000001000000000100000000010000000001000001
100100100000010010000001001000000100100000010010000001001001
100100100000010010000001001000000100100000010010000001001001
100001000010000100001000010000100001000010000100001000010001
100100C000000100C000000100C000000100C000000100C000000100C001
100100000000010000000001000000000100000000010000000001000001
100100100000010010000001001000000100100000010010000001001001
100001000000000100000000010000000001000000000100000000010011
100100C001100100C001100100C001100100C001100100C001100100C001
100100000110010000011001000001100100000110010000011001000001
100100C000000100C000000100C000000100C000000100C000000100C001
10010000000001000000000100000000010000000001000E000001000001
100100100000010010000001001000000100100000010010000001001001
100100100000010010000001001000000100100000010010000001001001
100001000000000100000000010000000001000000000100000000010011
100100C001100100C001100100C001100100C001100100C001100100C001
100100000000010000000001000000000100000000010000000001000001
100100100000010010000001001000000100100000010010000001001001
100001000000000100000000010000000001000000000100000000010011
100100C001100100C001100100C001100100C001100100C001100100C001
100100000000010000000001000000000100000000010000000001000001
100100000000010000000001000000000100000000010000000001000001
100100000000010000000001000000000100000000010000000001000001
111111111111111111111111111111111111111111111111111111111111